0 0 0 1 9 1 1 1 0 0
0 0 0 1 1 2 9 1 0 0
0 0 1 1 1 1 1 1 0 0
0 0 1 9 1 1 1 0 0 0
0 0 1 1 2 9 1 1 1 1
1 1 1 0 1 1 1 1 1 1
1 9 1 1 1 1 1 2 9 1
1 1 1 1 9 1 1 9 3 2
0 1 1 2 1 1 1 2 9 1
0 1 9 1 0 0 0 1 1 1
